--------------------------------------------------------------------------------------------------------------------------------------------------------------------------------------------------------
--------------------------------------------------------------------------------------------------------------------------------------------------------------------------------------------------------
--------------------------------------------------------------------------------------------------------------------------------------------------------------------------------------------------------
-----------------------------------------------------------------------------------------------------------------------------------------------------------------------B--------------------------------
--------------------------X-----------------------------------------------------------------------------------------------------------------------------------------------------------------------------
-------------------------XX--------------------------------------------------------------------------------------------------------------------------------------------------------------X--------------
------------------------XXX-------------------------------------------------------------------------------------------------------------------------------------------------------------XX--------------
-----------------------XXXX------------------------------------------------------------------------------------------------------------------------------------------------------------XXX-------v------
----------------------XXXXX-----------------------------------------------------------------------------------------------------------------------------------------------------------XXXX-------f------
---------------------XXXXXX----------------------------------------------------------------------------------------------------------------------------------------------------------XXXXX-------f------
--------------------XXXXXXX---------------------------------------------------------------------------------------------------------------------------------------------------------XXXXXX-------f------
-------------------XXXXXXXX--------------------------------------------------------------------------------------------------------------------------------------------------------XXXXXXX-------f------
------------------XXXXXXXXX-------------------------------------------------------------------------------------------------------------------------------------------------------XXXXXXXX-------f------
-----------------XXXXXXXXXX------------------------------------------------------------------------------------------------------------------------------------------X-----------XXXXXXXXX-------f------
m---------------XXXXXXXXXXX-----------------------------------------------------------------------------------------------------------------------------------------------------XXXXXXXXXX-------------X
XXXXXXXXXXXXXXXXXXXXXXXXXXXXXXXXXXXXXXXXXXXXXXXXXXXXXXXXXXXXXXXXXXXXXXXXXXXXXXXXXXXXXXXXXXXXXXXXXXXXXXXXXXXXXXXXXXXXXXXXXXXXXXXXXXXXXXXXXXXXXXXXXXXXXXXXXXXXXXXXXXXXXXXXXXXXXXXXXXXXXXXXXXXXXXXXXXXXXXXX
