--------------------------------------------------------------------------------------------------------------------------------------------------------------------------------------------------------
--------------------------------------------------------------------------------------------------------------------------------------------------------------------------------------------------------
--------------------------------------------------------------------------------------------------------------------------------------------------------------------------------------------------------
---------------------------------------------------------------------o----------------------------------------------------------------------------------------------------------------------------------
--------------------------------------------------------------------------M---------------------------o-------------------------XXXX--------------------------------------------------------------------
--------------------------------------------------------------------------------------------------------------------------------------------------------------------------------------------------------
--------------------------------------------------------------------------------------------------------------------------------------------------------------------------------------------------------
-------------------------------------------------------------------------------------------------------------------------------------------------------------------------------------------------v------
-------------------------------------------------------------------------------X-----------------------------------------------------------------------------------------------------------------f------
-----------------------------------------???-------------o--------------------XX-----------------------------------------------------------------------------------------------------------------f------
-----------------------------------------------B-----------------------------XXX------o---T------------------------------------------------------------------------------------------------------f------
----------------------------------------------------------------------------XXXX----------|-----M--------------T---------------------------------------------------------------------------------f------
----------------------------------------------------------------T----------XXXXX----------|--------------------|---------------------------------------------------------------------------------f------
----------------------------------------------------------------|---------XXXXXX----------|--------------------|---------------------------------------------------------------------------------f------
m--------BB-------------------------------------E---------------|--------XXXXXXX----------|--------------------|------------------------E--------------------------------------------------------------X
XX------XXXXXXXXXXXXXXXXXXXXXXXXXXXXXXXXXXXXXXXXXXXXXXXXXXXXXXXX|X------XXXXXXXXXXXXXXXXXX|---XXXXXXXX--------X|XXXXXXXXXXXXXXXXXXXXXXXXXXXXXXXXXXXXXXXXXXXXXXXXXXXXXXXXXXXXXXXXXXXXXXXXXXXXXXXXXXXXXXXX
