-----------------------------------------------------------------M--------------------------------------------------------------------------------------------------------------------------------------
--------------------------------------------------------------------------------------------------------------------------X-----------------------------------------------------------------------------
--------------------------------------------------B-----------------------------------------------------------------------------------------------------------------------------------------------------
--------------------------------------------------------------------------------------------------------------------------------------------------------------------------------------------------------
------------------------------------------------------------------------------?---------------------------------B-------------------------M----------------------------------T--------------------------
------------------------------------------------------------------------------------------?----------------------o-----------------------------------------------------------|--------------------------
---------------------------------M-------------------------------------------------------------------------------------------------------------------------------------------|--------------------------
----------------------------------------------------------------------------------------------------------------------------------------------------------------------------B|-------------------v------
----------------------------------------M-------------------------------XXXXX----------------------o-------------------------------------------------------------------------|-------------------f------
-----------X-----------------------------M-----------------------------------------------------------------------------------------------------------------------------------|-------------------f------
----------XX-----------------------------------------------------------------------------------------------------------------------------------------------------------------|-------------------f------
---------XXX-----------------------------------------------------------------------------------------------------------------------------------------------------XXXXXXXX----|-------------------f------
-------XXXXX-------------T------------------------------------------------------------o--------------------------------------------------------------------------------------|-------------------f------
-------XXXXX-------------|------------------------------XXXXX----------T-----------------------------------------------------------------------------BBBBBBBB----------------|-------------------f------
m-----XXXXXX-------------|---------------------------------------------|X-E-----------------------------X------------------------------------------------------E-------------|-------------------------X
XXXXXXXXXXXXXXXXXXXXXXXXX|XXXXX---------XXXXXXXXXXXXXXXXXXXXXXXXXXXXXXX|XXXXXXXXX---XXXXXXXXXXXXXXXXXXXXXXXXXXXXXXXXXXXXXXXXXXXXXXXXXXXXXXXXXXXXXXXXXXXXXXXXXXXXXXXXBBXXXXXXX|XXXXXXXXXXXXXXXXXXXXXXXXXX
