--------------------------------------------------------------------------------------------------------------------------------------------------------------------------------------------------------
--------------------------------------------------------------------------------------------------------------------------------------------------------------------------------------------------------
-----------------------------o--------------------------------------------------------------------------------------------------------------------------------------------------------------------------
---------------------------------------------------------------------o----------------------------------------------------------------------------------------------------------------------------------
-----------------------------------------------------------------------------------------------------X--------------------------------------------------------------------------------------------------
----------------------------------------------------------------------------------------------------XX--------------------------------------------------------------------------------------------------
---------------------------------------------------------------------------------------------------XXX-----------------------o--------------------------------------------------------------------------
--------------------------------------------------------------------------------------------------XXXX-------------------------------------------------------------------------------------------v------
--M-----------------------?????-----------------------------------------------o------------------XXXXX-------------------------------------------------------------------------------------------f------
-------------------T-----------------------------------------------------------XXXX-------------XXXXXX-------------------------------------------------------------------------------------------f------
---------X---------|---------------------------B--X--------------------------------------------XXXXXXX-------------------------------------------------------------------------------------------f------
------------X------|--------------------------------------------------------------------------XXXXXXXX-------------------------------------------------------------------------------------------f------
-o-----------------|--------o----------------------------------------------------------------XXXXXXXXX--------------------------------BBBBBBBB--XXXXXXXX-----------------------------------------f------
-------------------|--------------M---------------------------------------------------------XXXXXXXXXX-------------------------------------------------------------------------------------------f------
m------------------|-------E--------------------E------------------------------------------XXXXXXXXXXX-----------------------E----------E--------------------------------------------------------------X
XXXXXXXXXXXXXXXXXXX|XXXXXXXXXXXXXXXXXXXXXXXXXXXXXXXXXXXXXXXXXXXXXXXXXXXXXXX-----XXXXXXXXXXXXXXXXXXXXXX-------XXXXXXXXXXXXXXXXXXXXXXXXXXXXXXXXXXXXoXXXXXXXXXXXXXXXXXXXXXXXXXXXXXXXXXXXXXXXXXXXXXXXXXXXXXX
