-----------------XXXXXX---------------------------------------------------------------------------------------------------------------------------------------------------------------------------------
----------------------------------------------------------------------------------------------------------------------------------------------o---------------------------------------------------------
--------------------------------------------------------------------------------------------------------------------------------------------------------------------------------------------------------
---------------------------------------------------------------------o------------------B---------------------------------------------------------------------------------------------------------------
--------------------------------------------------------------------------------------------------------------------------------------------------------------------------------------------------------
----------------------------------------------------------------------------o---------------------------------------------------------------------------------------------------------------------------
----------------------------------------------------------------------------------------------------------------------BBBBBB----------------------------------------------------------------------------
-------------------------------------------------------------------------------------------------------------------------------------------------------------------------------------------------v------
-----B-------------------------------------------------------------------------------------------------------?---------------------o--------X----------------------------------------------------f------
-------------------------------------------------------?-----------------------------------------------------------------------------------------------------------------------------------------f------
-----X-----------------------------------------B---------------------------------------------------------------------X---------------------------------------------------------------------------f------
---------------------------------------------------------------------------------------------------------------T-o--XX---------------------------------------------------------------------------f------
---------------------------------------------------------------------------------------------------------------|---XXX---------------------------------------------------------------------------f------
---------------------------------------------------------------------------------------------------------------|--XXXX------------------------------------------------------------------------T--f------
m-------E-------------o-------------------------------------------------------------------------------------E--|-XXXXX------------------------------------------------------------------------|--------X
XXX------XXXXXXXXXXXXXXXXXXXXXXXXXXXXXXXXXXXXXXXXXXXXXXXXXXXXXXXXXXXXXXXXXX-----XXXXXXXXXXXXXXXXXXXX------XXXXX|XXXXXXXXXXXXXXXXXXXXXXXXXXXXXXXXXXXXXXXXXXXXXX--XXXXXXXXXXXXXXXXXXXXXXXXXXXXXX|XXXXXXXXX
