-----------------------------------------M------------?-------------------------------------------------------------------------------------------------------------------B-----------------------------
-----------------------------------------------------------------------------o--------------------------------------------------------------------------------------------------------------------------
------------------X-----------------------------------------o-----------------------------------------------------------------------------------------------X-------------------------------------------
----------------------------------------------------------------------------------------B---------------------------------------------------------------------------------------------------------------
--------------------------------------------------------------------------------------------------------------------------------------------------------------------------------------------------X-----
----------------------------------------------------------------------------o-----------------------?--------------------------------------------------------------------------------------------XX-----
--------------------------------------------------------------------------------------X-------------------------------------------------------------------------------------------B-------------XXX-----
-------------------------------------------------------------------------------------XX--------------------------------------------------------------------------------------------------------XXXX-----
------------------------------------------------------------------------------------XXX----------------------?------------------------------X-------------------------------------------------XXXXX---X-
-----------------------------------------------------------------------------------XXXX-------------o----------------------------------------------------------------------------------------XXXXXX-----
--------------------------------------------------------------------X-o-----------XXXXX------------------------------X----------------------------------------------------------------------XXXXXXX-----
--------------------X--------B-------------------------------------XX------------XXXXXX-----------------------------XX---------------------------------------------------------------------XXXXXXXX-----
-----------------------------------------------------------o------XXX-----------XXXXXXX----------------------------XXX--------------------------------------------------------------------XXXXXXXXX-----
-----------------------------------------------------------------XXXX----------XXXXXXXX---------------------------XXXX-------------------------------------------------------------------XXXXXXXXXX-----
m------------------------------------------------E--------------XXXXX---------XXXXXXXXX--------------------------XXXXX------------------------------------------------------------------XXXXXXXXXXX----X
XXXXXXXXXXXXXXXXXXXX---XXXXXXXXXXXXXXXXXXXXXXXXXXXXXXXXXXXXXXXXXXXXXX-----XXXXXXXXXXXXXXXXXXXXXXXXXX---XXXXXXXXXXXXXXXXXXXXXXXXXXXXXXXXXXXXXXXXXXXXXXXXXXXXXXXXXXXXXXXXXXXXXXXXXXXXXXXXXXXXXXXXXXXXXXXXX
