--------------------------------------------------------------------------------------------------------------------------------------------------------------------------------------------------------
----------------------------------------------------------------------------------------------------------------X---------------------------------------------------------------------------------------
--------------------------------------------------------------------------------------------------------------------------------------------------------------------------------------------------------
---------------------------------------------------------------------o----------------------------------------------------------------------------------------------------------------------------------
--------------------------------------------------------------------------------------------------------------------------------------------------------------------------------------------------------
--------------------------------------------------------------------------------------------------------------------------------------------------------------------------------------------------------
--------------------------------------------------------------------------------------------------------------------------------------------------------------------------------------------------------
-----------------------------------------------------------------------------------------------------------------------------------------------------------o-------------------------------------v------
------------------------------------------------------------------------------------------------------------------------------------------X------------------------------------------------------f------
-----------------------------------------------------------------------------------------------------------------------------------------XX------------------------------------------------------f------
------------------------------------?--------X------------------------------------------------------------------------------------------XXX------------------------------------------------------f------
--------------------------------------------XX-----------------------------------------------------------------------------------------XXXX------------------------------------------------------f------
-------------------------------------------XXX--------------BBBBBB----------------------------------------B---------------------------XXXXX-------------o--------?-------------------------------f------
------------------------------------------XXXX---------------------------------------------------------------------------------------XXXXXX------------------------------------------------------f------
m----------------------------------------XXXXX---------------------------------E------------X--------------------------------E------XXXXXXX-------------------E----------------------------------------X
XXXXXXXXXXXXXXX--XXXXXXXXXXXXXXXXXXXXXXXXXXXXXXXXXXXXXXXXXXXXXXXXXXXXXXXXXXXXXXXXXXXXXXXXXXXXXXXXXXXXXXXXXXXXXXXXXXXXXXXXXXXXXXXXXXXXXXXXXXXXXXXXXXXXXXXXXXXXXXXXXXXXXXXXXXXXXXXXXXXXXXXXXXXXXXXXXXXXXXX
