------------------------------------------------------?-------------------------------------------------------------------------------------------------------------------B-----------------------------
-----------------------------------------------------------------------------o----o-----------------------------------------------------------o---------------------------------------------------------
------------------X-----------------------------------------o-----------------------------------------------------------------------------------------------X-------------------------------------------
----------------------------------------------------------------------------------------B---------------------------------------------------------------------------------------------------------------
-----------------------------M--------------------------------------------------------------------------------------------------------------------------------------------------------------------X-----
----------------------------------------------------------------------------o-----------------------?--------------------------------------------------------------------------------------------XX-----
------------------------------------------------------------------------------------------------------------------------------------------------------------------------------------------------XXX-----
-----------------------------------------------------------------------------------------------------------------------------------------------------------------------------------o-----------XXXX-----
---XXXXXXX---------------------------------------------------------------------------------------------------?------------------------------X-------------------------------------------------XXXXX-----
----------------------------------------------------------------------------------------------------o----------------------------------------------------------------------------------------XXXXXX-----
--------------------------------------------------------------------X------------------------------------------------X----------------------------------------------------------------------XXXXXXX-----
-------------------------------------------------------------------XX-----------------------------------------------XX---------------------------------------------------------------o-X---XXXXXXXX-----
-----------------------------------------------------------o------XXX----------------------------------------------XXX-----------------------------------------------------------------XX-XXXXXXXXX-----
-----------------------------------------------------------------XXXX---------------------------------------------XXXX-----------------------------------------------------------------XXXXXXXXXXXX-----
m---------------------------------------------------------------XXXXX----------------------------------------E---XXXXX-----------------------------------------------------------------XXXXXXXXXXXX----X
XXXXXXXXXXXXXXX----XXXXXXXXXXXXXXXXXXXXXXXXXXXXXXXXXXXXXXXXXXXXXXXXXXXXXXXXXXXXXXXXXXXXXXXXXXXXXXXXX---XXXXXXXXXXXXXXXXXXXXXXXXXXXXXXXXXXXXXXXXXXXXXXXXXXXXXXXXXXXXXXXXXXXXXXXXXXXXXXXXXXXXXXXXXXXXXXXXX
