--------------------------------------------------------------------------------------------------------------------------------------------------------------------------------------------------------
--------------------------------------------------------------------------------------------------------------------------------------------------------------------------------------------------------
--------------------------------------------------------------------------------------------------------------------------------------------------------------------------------------------------------
----------------------------------------X----------------------------o-o--------------------------------------------------------------------------------------------------------------------------------
--------B-----------------------------------------------------------------------------------------------------------------------------------------------------------------------------------------------
----------------------------------------------------------------------X---------------------------------------------------------------------------------------------------------------------------------
--------------------------------X------------------------------------XX---------------------------------------------------------------------------------------------------------------------------------
--------------------------------------------------------------------XXX--------------------------------------------------------------------------------------------------------------------------v------
-------------------------------------------------------------------XXXX-------------------------------------------------------------------X------------------------------------------------------f------
------------------------------------------------------------------XXXXX------------------------------------------------------------------XX------------------------------------------------------f------
------------------------------------?--------X-------------------XXXXXX-----------------------------------------------------------------XXX------------------------------------------------------f------
--------------------------------------------XX------------------XXXXXXX----------------------------------------------------------------XXXX------------------------------------------------------f------
-------------------------------------------XXX-----------------XXXXXXXX---------------------------------------------------------------XXXXX-------o----------------------------------------------f------
-----------------------------------M------XXXX----------------XXXXXXXXX--------------------------------------------------------------XXXXXX------------------------------------------------------f------
m----------------------------------------XXXXX---------------XXXXXXXXXX--------E------------X--------------------------------E------XXXXXXX----------------------------E-------------------------------X
XXXXXXXXXXXXXXXXXXXXXXXXXXXXXXXXXXXXXXXXXXXXXXXXXXXXXXXXXXXXXXXXXXXXXXXXXXXXXXXXXXXXXXXXXXXXXXXXXXXXXXXXXX--------XXXXXXXXXXXXXXXXXXXXXXXXXXXXXXXXXXXXXXXXXXXXXXXXXXXXXXXXXXXXXXXXXXXXXXXXXXXXXXXXXXXXXX
