--------------------------------------------------------------------------------------------------------------------------------------------------------------------------------------------------------
--------------------------------------------------------------------------------------------------------------------------------------------------------------------------------------------------------
--------------------------------------------------------------------------------------------------------------------------------------------------------------------------------------------------------
-----------------------X--------------------------------------------------------------------------------------------------------------------------------------------------------------------------------
--------------------------------------------------------------------------------------------------------------------------------------------------------------------------------------------------------
----------------------------------------------------------------------X-----------------------------------------------------o---------------------------------------------------------------------------
---------------------------------------------------------------------XX---------------------------------------------------------------------------------------------------------------------------------
--------------------------------------------------------------------XXX--------------------------------------------------------------------------------------------------------------------------v------
-------------------------------------------------------------------XXXX--------------------------------------------------------------------------------------------------------------------------f------
------------------------------------------------------------------XXXXX--------------------------------------------------------------------------------------------------------------------------f------
-----------------------------------------------------------------XXXXXX-------------------------------------------------------------?------------------------------------------------------------f------
----------------------------------------------------------------XXXXXXX------------------------------------------------------------------------------------------XXXXXXXX------------------------f------
---------------------------------------------------------------XXXXXXXX---------------------------------------------------------------------------o----------------------------------------------f------
--------------------------------------------------------------XXXXXXXXX--------------------------------------------------------------------------------------------------------------------------f------
m------------------------------------------------------------XXXXXXXXXX--------------------------------------------------------------------------------------------------------------------------------X
XXXXXXXXXXXXXXXXXXXXXXXXXXXXXXXXXXXXXXXXXXX----XXXXXXXXXXXXXXXXXXXXXXXXXXXXXXXXXXXXXXXXXXXXXXXXXXXXXXXXXXXXXXXXXXXXXXXXXXXXXXXXXXXXXXXXXXXXXXXXXXXXXXXXXXXXXXXXXXXXXXXXXXXXXXXXXXXXXXXXXXXXXXXXXXXXXXXXX
