-----------?-------------------M---B---MB--?-?-----------------------M--MM---------------------B--------------?------?-------?---------o-o-----------------------------------o---M?---------------------
------------------------------------?---------B--M-----------------------B?---M-------------M------------------------B----------------B-B--------------M-M-M---------B---------------------------?------
------------B-----B-------?-----------o----?Bo------B---------------------------B------------MM----?M------o------------------------?-------------o---------BM----?-------------------------------T-----
------------------------M--------o--B--------o-B----------B--------o--------BB--M------?-------?---?----M---------B-----?o--------------?---B-------------B-------M---------------------------|---------
----------------o-oM---M-----?----------------?--?----------------?------?-----------------B-----?B------?------M---------------oM-----M--o-----B-M-----Mo-?---?----------------------------------------
----------?---B-----BB--------B-o----o------B---M-B-o--------------------B------------------M--------?-o------BM----B--------------------------------B-?--------------M-----B--------B-------M--M-------
--------------M-------------------------------M-------o------?---------B-o---M-----------B---o--M-------------o---------oB-BM-------B------BB----o----------B---------------------------B-?------EM-----
--------------------B--------------?------M--------------M--oB----B---o---o-----MM---------M---B---?-----------------------------?------------B-o----------o-----------------M----M?------B-----|v------
----------------------M------B--o---------M--?-M-M?B--------oM----------o--B---------------------o--------o-M--M----M----o-----------M------?----B---M---oo---B------------?--------------------|f------
------------Bo-----B----------o-----------------?-----------------Bo------------?------B---M------M--------------B----?--------?----M-------Mo----B--o--?-----------------------------?--------?-f------
-----------------------------?--?-B------------------------?----?-----------o-----o------o------------------B--?---?-------------?---------B-o-----------B--------------?----oo------------------f------
-------------------------------o----B---------------?------------------------o??-------B-----------o--------------------?--o----?------oo-----?--------o--B-B----------?-------------------------X------
-------------------------------------T?----T---------------Eo-------------?-T-------------------------o-----------?--------oE--T-------------E--B-------------------B-------T-------------------Xf------
-------------o------?------------E--------------T----?----T---B----o-------T---E-o--o-T-----------Bo--E--E-o------Eo-?-----o-------T----EE-------o-------------?----B-----B----------------------X?-----
m---------X----EETE-T--X-----Bo--?-o--E?---o-E---X-------B------?---o---?-----T-o--o---E---o-------------------T----Xo--------------B----X-------------E----X----------X------------------------|------X
XXXXXXXXXXXXXXXXXXXXXXXXXXXXXXXXXXXXXXXXXXXXXXXXXXXXXXXXXXXXXXXXXXXXXXXXXXXXXXXXXXXXXXXXXXXXXXXXXXXXXXXXXXXXXXXXXXXXXXXXXXXXXXXXXXXXXXXXXXXXXXXXXXXXXXXXXXXXXXXXXXXXXXXXXXXXXXXXXXXXXXXXXXXXXXXXXXXXXXXX
