-------o---------------------------|---?|-?--o---|-----------------?-|-----B------B-?------------M----------------B-B-----------------------------------------M-BB-----------B---|----------------------
-------------------M-----------------|-------------------------------M------BB----------|-----------------------------------------------------?o--------------------B-----?--?--B-----------------------
--B---o-----------?-----o-------------B------------|--B----o----------------------------?----M?---B----------?---------------------------------------M-B------o-------------------M----?-------B--M-----
------------------M-----B-M--?------------M----------B---------|---?--|--B---------?-------------------------------B?------------?---?--------------------|B----B-|----|----?------|-o--M|--------B-----
---?---------B---M---M---M-----|----|-----------------B---------------------B-?------------?--?----M----------------o--M-------------|---------|------------M-o----------o---M--------------------------
------------M?------B---------?------|----------M-M------M-----o-----B?--M------o-----M----------M-M---------M-------------B---------Mo----B--------------o--B-------------------|-|?------M------------
-----------------------M|-----|M--M-----?------o---------B------------------B------|------------------B|-------BB----------------?----------------------------o-------?-M-------------M------o--B-------
---||----|M---?-------------B----|---?--B--|----------------|-------------------------|------------------------|?M--------------|-B----B-----------------?--------?------------M----o---------M----v----
-----------o-------M--M--M----------?-------M--------B--|--B------M---------B-M----BM------?-----------o------|------B?---?------o-------M----?---oM-------|---------M-----|-BoB------M|----o--?-------f
--o---------?--------------?-----o?oM-M?----M---|----------o-o---------|--B---B----M--------------------------------M------------------M-----BM--------|?-----?-----------------o----------------------f
----?---------MM-----B----o-----o---M|---------?---Bo---B---------B-B-----?----|----M------B-o-----B------M----M-----|M-------?-------o-o-----------|-------?-----?---M------M-------------------------f
-----B---M------M--------------|-|?-------M------||---------------o-----------o---------M-|-M-o------B------------M----?---B------------M----------------|--M----------------?---|--o-----------M------f
--?BB---B----T----E------M---------------E--------?|----|E---B---|--?E--o--?---oM--T-MMBT--oo-?-o-|---M-B-------------MT------E---T-M-T----------o----Eo-|---?--|---o----T---o----------------B--------f
----Bo------o--E--------T---T----------M-------M-------oo-o--E-E-M---E-----M----ET----E---B---E---oM-------M-o--T---T---oE-??---------B---o------------M---Bo------?--BT-----M---oM---------------M----f
m?-BXT---------TT------------o-----EX-------M------E--B---------?----------E-----?---------B---ooB--------o-X-?---TB------E--oB--o------E-E---------E----?--------o-T--------o--E---?B--------E--------X
XXXXXXXXXXXXXXXXXXXXXXXXXXXXXXXXXXXXXXXXXXXXXXXXXXXXXXXXXXXXXXXXXXXXXXXXXXXXXXXXXXXXXXXXXXXXXXXXXXXXXXXXXXXXXXXXXXXXXXXXXXXXXXXXXXXXXXXXXXXXXXXXXXXXXXXXXXXXXXXXXXXXXXXXXXXXXXXXXXXXXXXXXXXXXXXXXXXXXXXX
