--------------------------------------------------------------------------------------------------------------------------------------------------------------------------------------------------------
--------------------------------------------------------------------------------------------------------------------------------------------------------------------------------------------------------
--------------------------------------------------------------------------------------------------------------------------------------------------------------------------------------------------------
--------------------------------------------------------------------------------------------------------------------------------------------------------------------------------------------------------
--------------------------------------------------------------------------------------------------------------------------------------------------------------------------------------------------------
---------------------------------------------------------------------------------------------------------------------------------------------------------------------------B----------------------------
-----------?B-----B-?o-B-MBM--o-B--B---B-M---o?M--o-o?-o?-M--?B-?--?o------M-B?o-?MoB-B-M--o--M----------M--M?M?--M--?-B-----oB------o-?oo---M-oo-B-?BB-?-o--B-oBoM---MB-o---?------M-BM?M--MM----------
-------------MB---o-----o----M----?o--?------B--B?-----B-?--B--M----o--BM------?---M-Mo?-------------?M?--M----o----------B--------oB---??oMM---Bo-----M-M?M--MM-----M--M---------Mo----o-?B-----v------
-------------o-M-oo----?---M----?-------B--B---?----B-B---M--M--?--------BM---?-Mo--?-M-B--B--?-?--MB---oo----------o-M-o-o--B-?B-?-------o----B---?o----o--oB--?---o-o----o-BBMB?-?---??---------------
-----------M-M?---o-B-?-o-----o------M-Mo---?-B--Moo-B------B--o-M-?--oo-------o-?--------o-?M-o-----Mo-o-o----o-??oB----M-o--M-----?o------o-----?--o-M?-----o-o-oo---B?-M---------o---o-o--o----------
-------------o--oo-----------------------------------------o-------oo--o--o-----o---------o----------------o--o-o----------------------------o---o-----------o-------o-----------------oo---------------
------------------------o---o-----o------------------------oo-----------------------------o------------------oo----o------o----o------o--oo---o---------o---o-------o----------------o------------------
-----------o--------o-E-o-o-o--E-oET-o--ooE-oo---E-------oEE--E----------ET-T--E-Tooo---o--E--ET--T-T--o-----------------o-TE-o---T-oT-o----E----T---oE----o--o----------oEE---------T----E--o----------
--------------T---E---E-----T-o-E--|-T-----E----------T---T--------T---T--|-|--o-|---T-----E---|TT|E|---T-Eoo--T---------E-|E--E--|-E|E-T--E-T---|TE-E----T---o--T------------E-E-TE-|-------T----------
m----------oo-|X--o-E----X--|-EE--E|E|-o--EXoXooE-X---|XT-|-X--o---|oT-|E-|-|--E-|E--|----X-T--||||-|-X-|T--E--|-oo-E--E--X|---T-X|-X|X-|----|--T||T--o-E-|EX----|-TE-Xoo-E-----X-|--|Xo-----|----------
XXXXXXXXXXX|XX|XXX||XXXXXXXX|X|XXXX|||XXX|XXXXX||X||X||||||||X|X|XX|||X|XX|X|XXXX|X|X|XX|XXX|X|||||||XXX|||X||X|XXXXX|XX|XX|XX||X||XX||X|XXXX|XX||||XX|XXX|XX||X||||XX||X|X|XXXXXX||X|XXXXXXX|XXXXXXXXXX
