---------------------------------------------------------------------o----------------------------------------------------------------------------------------------------------------------------------
------------------------------------------------------------------B------------------------------------------------------------------------------------------------------X------------------------------
------------------------------------------------------------------------------------------------------------------------------------------------------------B-------------------------------------------
-------------------------------------------------------------------------------------------------------M------------------------------------------------------------------------------------------------
---------------------------------------------------------------------------------------------------X----------------------------------------------------------------------------------------------------
--------------------------------------------------------------------------------------------------XX-------------XXXXXX---------------------------------------------------------------------------------
---------------X---------------------------------------------------------------------------------XXX-------------------X--------------------------------------------------------------------------------
------------------------------------------------------------------------------------------------XXXX------------------XX-------------------------------------------------------------------------v------
---------------------------X--------T----------------------------------------------------------XXXXX-----------------XXX-------------------------------------------------------------------------f------
--------------------------XX--------|---------------------------------------------------------XXXXXX----------------XXXX-------------------------------------------------------------------------f------
-------------------------XXX--------|--------------------------------------------------------XXXXXXX---------------XXXXX-------------------------------------------------------------------------f------
------------------------XXXX--------|---------------------------XXX-------------------------XXXXXXXX--------------XXXXXX-----------T-------------------------------------------------------------f------
-----------------------XXXXX--------|------------------------------------------------------XXXXXXXXX-------------XXXXXXX-----------|-------------------------------------------------------------f------
----------------------XXXXXX--------|-----------------------------------------------------XXXXXXXXXX------------XXXXXXXX-----------|-------------------------------------------------------------f------
m--------------------XXXXXXX--------|-------E---B---------E--?---------------------E-----XXXXXXXXXXX-----------XXXXXXXXX-E---------|-------------------------------------------------------------------X
XXXXXXXXXXXXXXXXXXXXXXXXXXXXXXXXXXXX|XXX------XXXXXXXXXX---XXXXX---XXXXXXXXXXXXXXXXXXXXXXXXXXXXXXXXXXXXXXXXXXXXXXXXXXXXXXXXXXXXXXXX|XXXXXXXXXXXXXXXXXXXXXXXXXXXXXXXXXXXXXXXXX-----XXXXXXXXXXXXXXXXXXXXXX
